# # # # # -
# K # K E -
# K K K # -
# K E M # -
# # # # # /
# # # # # -
K K # E # -
K K K K K -
# E K # M -
# # # # # /
# # # # # -
# # K # # -
# M E K K -
K K K E K -
# # # # # /
# # # # # -
# E K K # -
K K # K K -
# M K E # -
# # # # # /
# # # # # -
E K M K # -
# K # K # -
K K E # # -
# # # # # .